-11
11
-7
7
00000000000000000000000
00000000000000000000000
00000000000000000000000
00100000010000001111000
00100000010000001111000
00100000010000001111000
00111001110000001111000
00000000000000000111000
00000000000000000111000
00000000000000000000000
00000000000000000000000
00000000000000000000000
00000000000000000000000
00000000000000000000000
00000000000000000000000
