-9
9
-1
5
0000000000000000000
0000000100001111110
0000000100001111110
0000000100001111110
1110011100001111110
0000000000000011100
0000000000000011100
